XXXXXXXXXXXXXXX
X             X
X XXXXXXXXXXXXX
X X         X X
X XXXXXXXXX X X
X XXXXXXXXX X X
X XXXX      X X
X XXXX XXXX X X
X XXXX XXXX X X
X X    XXXXXX X
X X XXXXXXXXX X
X X XXXXXXXXX X
X X         X X
X XXXXXXXXX   X
XXXXXXXXXXXXXXX
